alius --another --
Alter --the other --
Ante -- before --
Apud -- among, beside, at the house of --
Aut -- or --
Aut?aut -- either ?or --
Circum -- around --
Cras -- tomorrow --
Deinde -- then, from there --
Diu -- for a long time --
Etiam -- also --
Fortasse -- perhaps --
Heri--yesterday --
Hic -- here --
Hic, haec, hoc -- this --
Hodie--today --
Ille, illa, illud -- that --
Iam -- now, already --
Ibi -- there --
Idem, eadem, idem -- the same --
Illuc -- (to) there --
Inter -- among --
Ipse, ipsa, ipsum -- himself, herself, itself --
Is, ea, id -- he, she, it --
Ita -- thus --
Itaque -- and so, therefore --
Lente -- slowly --
Mane -- early in the morning. Morning --
Nam -- for, because --
Neque -- neither --
Neque?neque -- neither?nor --
Nisi -- unless --
Nullus -- no, none --
Numquam -- never --
Nunc -- now --
Ob -- on account of --
Olim -- once, once upon a time --
Post -- after, behind --
Postea -- afterwards --
Postquam -- after --
Postridie -- the next day, the day after --
Propter -- on account of --
Quamquam -- although --
Qui, quae, quod -- who, which --
Quod -- because --
Quoque--also --
Satis -- enough --
Simul -- at the same time --
Statim -- at once, immediately --
Super -- above --
Tam -- so, so much --
Tamen -- however --
Tandem -- at last --
Trans -- across --
Tum -- then --
Ullus -- any --
Vix -- scarcely, hardly, with difficulty --
